//####///
###  ####
#     . #
# #  #$ #
#    #@ #
#########